   NO    ./textures/text.xpm

SO   ./textures/text2.xpm
WE       ./textures/text3.xpm
EA                 ./textures/text4.xpm

F               220,100,230

C  20,30,65

        1111111111111111111111111
        1000000000110000000000001
        101100000111000E000000001
        1001000000000000000000001
111111111011000001110000000000001
11111111 1111111 1111111111111111

