NO    ./textures/no.xpm
SO   ./textures/so.xpm
WE       ./textures/we.xpm
EA                 ./textures/ea.xpm

F 38,48,64
C     135,206,235

111111111111111111111111
111111111111111111111111
10000000000000000000001111
101111011111111110111101
101000010000000101000001
101011110111110101011101
101010000100001101010001
101010111101101101011101
101010100001001001000001
101010101111101011111101
101000101000001000001001
101111101011111111101001
100000001010000000001001
111111101010111111101001
100000001000100000000001
101110S01111010111111101
100010010000000100000001
111111111111111111111111

